0 0 0 0 0 0 0 0 0 0 0 0 0 0 0 0 0 0 0 0 0 0 0 0 0 0 0 0
0 0 0 0 0 0 0 0 0 0 0 0 0 0 0 0 0 0 0 0 0 0 0 0 0 0 0 0
0 0 0 0 0 0 0 0 0 0 0 0 0 0 0 0 0 0 0 0 0 0 0 0 0 0 0 0
0 0 0 0 0 0 0 0 0 0 0 0 0 0 0 0 0 0 0 0 0 0 0 0 0 0 0 0
0 n p p p p n p p p p p n 0 0 n p p p p p n p p p p n 0
0 p 0 0 0 0 p 0 0 0 0 0 p 0 0 p 0 0 0 0 0 p 0 0 0 0 p 0
0 p 0 0 0 0 p 0 0 0 0 0 p 0 0 p 0 0 0 0 0 p 0 0 0 0 p 0
0 p 0 0 0 0 p 0 0 0 0 0 p 0 0 p 0 0 0 0 0 p 0 0 0 0 p 0
0 n p p p p n p p n p p n p p n p p n p p n p p p p n 0
0 p 0 0 0 0 p 0 0 p 0 0 0 0 0 0 0 0 p 0 0 p 0 0 0 0 p 0
0 p 0 0 0 0 p 0 0 p 0 0 0 0 0 0 0 0 p 0 0 p 0 0 0 0 p 0
0 n p p p p n 0 0 n p p n 0 0 n p p n 0 0 n p p p p n 0
0 0 0 0 0 0 p 0 0 0 0 0 | 0 0 | 0 0 0 0 0 p 0 0 0 0 0 0
0 0 0 0 0 0 p 0 0 0 0 0 | 0 0 | 0 0 0 0 0 p 0 0 0 0 0 0
0 0 0 0 0 0 p 0 0 + - - + - - + - - + 0 0 p 0 0 0 0 0 0
0 0 0 0 0 0 p 0 0 | 0 0 0 0 0 0 0 0 | 0 0 p 0 0 0 0 0 0
0 0 0 0 0 0 p 0 0 | 0 0 0 0 0 0 0 0 | 0 0 p 0 0 0 0 0 0
1 - - - - - n - - + 0 0 0 0 0 0 0 0 + - - n - - - - - 1
0 0 0 0 0 0 p 0 0 | 0 0 0 0 0 0 0 0 | 0 0 p 0 0 0 0 0 0
0 0 0 0 0 0 p 0 0 | 0 0 0 0 0 0 0 0 | 0 0 p 0 0 0 0 0 0
0 0 0 0 0 0 p 0 0 + - - - - - - - - + 0 0 p 0 0 0 0 0 0
0 0 0 0 0 0 p 0 0 | 0 0 0 0 0 0 0 0 | 0 0 p 0 0 0 0 0 0
0 0 0 0 0 0 p 0 0 | 0 0 0 0 0 0 0 0 | 0 0 p 0 0 0 0 0 0
0 n p p p p n p p n p p n 0 0 n p p n p p n p p p p n 0
0 p 0 0 0 0 p 0 0 0 0 0 p 0 0 p 0 0 0 0 0 p 0 0 0 0 p 0
0 p 0 0 0 0 p 0 0 0 0 0 p 0 0 p 0 0 0 0 0 p 0 0 0 0 p 0
0 N p n 0 0 n p p n p p n p p s p p n p p n 0 0 n p N 0
0 0 0 p 0 0 p 0 0 p 0 0 0 0 0 0 0 0 p 0 0 p 0 0 p 0 0 0
0 0 0 p 0 0 p 0 0 p 0 0 0 0 0 0 0 0 p 0 0 p 0 0 p 0 0 0
0 n p n p p n 0 0 n p p n 0 0 n p p n 0 0 n p p n p n 0
0 p 0 0 0 0 0 0 0 0 0 0 p 0 0 p 0 0 0 0 0 0 0 0 0 0 p 0
0 p 0 0 0 0 0 0 0 0 0 0 p 0 0 p 0 0 0 0 0 0 0 0 0 0 p 0
0 n p p p p p p p p p p n p p n p p p p p p p p p p n 0
0 0 0 0 0 0 0 0 0 0 0 0 0 0 0 0 0 0 0 0 0 0 0 0 0 0 0 0
0 0 0 0 0 0 0 0 0 0 0 0 0 0 0 0 0 0 0 0 0 0 0 0 0 0 0 0
0 0 0 0 0 0 0 0 0 0 0 0 0 0 0 0 0 0 0 0 0 0 0 0 0 0 0 0